//MAP CONVERTED BY dmm2tgm.py THIS HEADER COMMENT PREVENTS RECONVERSION, DO NOT REMOVE
"a" = (
/turf/template_noop,
/area/space)
"j" = (
/turf/simulated/mineral/random/high_chance/exoplanet,
/area/space)
"n" = (
/turf/simulated/mineral/random/exoplanet,
/area/space)

(1,1,1) = {"
a
a
a
a
a
a
a
a
a
a
a
a
a
a
a
a
a
a
a
a
a
a
a
a
a
a
a
a
a
a
a
a
"}
(2,1,1) = {"
a
a
a
a
a
a
a
a
a
a
a
a
a
a
a
n
n
n
n
a
a
a
a
a
a
a
a
a
a
a
a
a
"}
(3,1,1) = {"
a
a
a
a
a
a
a
a
a
a
a
a
a
n
n
n
n
n
n
n
n
a
a
a
a
a
a
a
a
a
a
a
"}
(4,1,1) = {"
a
a
a
a
a
a
a
a
a
a
a
a
n
n
n
n
n
n
n
n
n
n
a
a
a
a
a
a
a
a
a
a
"}
(5,1,1) = {"
a
a
a
a
a
a
a
a
a
a
a
n
n
n
n
n
n
n
n
n
n
n
n
n
a
a
a
a
a
a
a
a
"}
(6,1,1) = {"
a
a
a
a
a
a
a
a
a
a
n
n
n
n
n
n
n
n
n
n
n
n
n
n
n
a
a
a
a
a
a
a
"}
(7,1,1) = {"
a
a
a
a
a
a
a
a
a
n
n
n
n
n
n
n
n
n
n
n
n
n
n
n
n
n
a
a
a
a
a
a
"}
(8,1,1) = {"
a
a
a
a
a
a
a
a
n
n
n
n
n
n
n
n
n
n
n
n
n
n
n
n
n
n
a
a
a
a
a
a
"}
(9,1,1) = {"
a
a
a
a
a
a
a
a
n
n
n
n
n
n
n
n
n
a
a
n
n
n
n
n
n
n
n
a
a
a
a
a
"}
(10,1,1) = {"
a
a
a
a
a
a
a
n
n
n
n
n
n
n
n
n
a
a
a
a
n
n
n
n
n
n
n
a
a
a
a
a
"}
(11,1,1) = {"
a
a
a
a
a
a
n
n
n
n
n
n
n
n
n
a
a
a
a
a
a
n
n
n
n
n
n
n
a
a
a
a
"}
(12,1,1) = {"
a
a
a
a
a
a
n
n
n
n
n
n
n
n
a
a
a
a
a
a
a
a
n
n
n
n
n
n
n
a
a
a
"}
(13,1,1) = {"
a
a
a
a
a
n
n
n
n
n
n
n
n
a
a
a
a
a
a
a
a
a
a
n
n
n
n
n
n
a
a
a
"}
(14,1,1) = {"
a
a
a
a
a
n
n
n
n
n
n
n
a
a
a
a
a
a
a
a
a
a
a
a
n
n
n
n
n
a
a
a
"}
(15,1,1) = {"
a
a
a
a
a
n
n
n
n
n
a
a
a
a
a
a
j
j
j
j
j
a
a
a
n
n
n
n
n
n
a
a
"}
(16,1,1) = {"
a
a
a
a
n
n
n
n
n
a
a
a
a
a
a
j
j
j
j
j
j
a
a
a
n
n
n
n
n
n
a
a
"}
(17,1,1) = {"
a
a
a
a
n
n
n
n
a
a
a
a
a
a
j
j
j
j
j
j
j
j
a
a
n
n
n
n
n
n
n
a
"}
(18,1,1) = {"
a
a
a
a
n
n
n
n
a
a
a
a
a
j
j
j
j
j
j
j
j
j
a
a
a
n
n
n
n
n
n
a
"}
(19,1,1) = {"
a
a
a
n
n
n
n
a
a
a
a
a
j
j
j
j
j
j
j
j
j
j
a
a
a
n
n
n
n
n
n
a
"}
(20,1,1) = {"
a
a
a
n
n
n
n
a
a
a
a
a
j
j
j
j
j
j
j
j
j
j
a
a
a
a
n
n
n
n
n
a
"}
(21,1,1) = {"
a
a
a
n
n
n
a
a
a
a
a
j
j
j
j
j
j
j
j
j
j
j
a
a
a
a
n
n
n
n
n
a
"}
(22,1,1) = {"
a
a
a
n
n
n
a
a
a
a
a
j
j
j
j
j
j
j
j
j
j
a
a
a
a
a
n
n
n
n
n
a
"}
(23,1,1) = {"
a
a
n
n
n
a
a
a
a
a
a
j
j
j
j
j
j
j
j
j
j
a
a
a
a
a
a
n
n
n
n
a
"}
(24,1,1) = {"
a
a
n
n
n
a
a
a
a
a
a
j
j
j
j
j
j
j
j
j
a
a
a
a
a
a
a
n
n
n
n
a
"}
(25,1,1) = {"
a
n
n
n
n
a
a
a
a
a
a
a
j
j
j
j
j
j
a
a
a
a
a
a
a
a
a
a
n
n
a
a
"}
(26,1,1) = {"
a
n
n
n
a
a
a
a
a
a
a
a
j
j
j
j
a
a
a
a
a
a
a
a
a
a
a
a
n
n
a
a
"}
(27,1,1) = {"
a
n
n
n
a
a
a
a
a
a
a
a
a
a
a
a
a
a
a
a
a
a
a
a
a
a
a
a
n
a
a
a
"}
(28,1,1) = {"
a
n
n
a
a
a
a
a
a
a
a
a
a
a
a
a
a
a
a
a
a
a
a
a
a
a
a
a
a
a
a
a
"}
(29,1,1) = {"
a
a
n
a
a
a
a
a
a
a
a
a
a
a
a
a
a
a
a
a
a
a
a
a
a
a
a
a
a
a
a
a
"}
(30,1,1) = {"
a
a
n
a
a
a
a
a
a
a
a
a
a
a
a
a
a
a
a
a
a
a
a
a
a
a
a
a
a
a
a
a
"}
(31,1,1) = {"
a
a
a
a
a
a
a
a
a
a
a
a
a
a
a
a
a
a
a
a
a
a
a
a
a
a
a
a
a
a
a
a
"}
