//MAP CONVERTED BY dmm2tgm.py THIS HEADER COMMENT PREVENTS RECONVERSION, DO NOT REMOVE
"a" = (
/turf/simulated/mineral/random/exoplanet,
/area/space)
"n" = (
/obj/effect/decal/cleanable/blood/splatter,
/obj/random/melee,
/turf/simulated/floor/exoplanet/barren/cave,
/area/space)
"t" = (
/obj/structure/closet/crate/loot,
/turf/simulated/floor/exoplanet/barren/cave,
/area/space)
"x" = (
/turf/template_noop,
/area/space)
"z" = (
/turf/simulated/floor/exoplanet/barren/cave,
/area/space)
"H" = (
/turf/simulated/floor/exoplanet/water/shallow,
/area/space)
"L" = (
/obj/effect/decal/cleanable/blood/drip,
/turf/simulated/floor/exoplanet/barren/cave,
/area/space)

(1,1,1) = {"
x
x
x
x
x
x
x
x
x
x
x
x
x
x
x
x
x
x
x
x
x
x
x
x
x
x
x
x
x
x
x
x
x
x
x
x
x
x
x
"}
(2,1,1) = {"
x
x
x
x
x
x
x
x
x
x
x
x
a
a
a
a
a
a
a
x
x
x
x
x
x
x
x
x
x
x
x
x
x
x
x
x
x
x
x
"}
(3,1,1) = {"
x
x
x
x
x
x
x
x
x
x
a
a
a
a
a
a
a
a
a
a
a
a
x
x
x
x
x
x
x
x
x
x
x
x
x
x
x
x
x
"}
(4,1,1) = {"
x
x
x
x
x
x
x
x
a
a
a
a
a
a
a
a
a
a
a
a
a
a
a
a
a
a
a
x
x
x
x
x
x
x
x
x
x
x
x
"}
(5,1,1) = {"
x
x
x
x
x
x
x
a
a
a
a
a
a
a
a
a
a
a
a
a
a
a
a
a
a
a
a
a
a
a
a
x
x
x
x
x
x
x
x
"}
(6,1,1) = {"
x
x
x
x
x
x
a
a
a
a
a
a
z
a
a
a
a
a
a
a
a
a
a
a
a
a
a
a
a
a
a
a
a
x
x
x
x
x
x
"}
(7,1,1) = {"
x
x
x
x
a
a
a
a
a
z
H
H
H
H
a
a
a
a
a
a
a
a
a
a
a
a
a
a
a
a
a
a
a
a
a
a
x
x
x
"}
(8,1,1) = {"
x
x
x
a
a
a
a
a
z
H
H
H
H
H
H
a
a
a
a
a
a
a
a
a
a
a
a
a
a
a
a
a
a
a
a
a
a
x
x
"}
(9,1,1) = {"
x
x
x
a
a
a
a
a
H
H
H
H
H
H
H
H
a
a
a
a
a
a
a
a
a
a
a
a
a
a
a
a
a
a
a
a
a
x
x
"}
(10,1,1) = {"
x
x
x
a
a
a
a
a
H
H
H
H
H
H
H
H
z
a
a
a
a
a
a
a
a
a
a
a
a
a
a
a
a
a
a
a
a
a
x
"}
(11,1,1) = {"
x
x
a
a
a
a
a
a
H
H
H
H
H
H
H
a
a
a
a
a
a
a
a
a
a
a
a
a
a
a
a
a
a
a
a
a
a
a
x
"}
(12,1,1) = {"
x
x
a
a
a
a
a
a
z
H
H
H
H
z
a
a
a
a
a
a
a
a
a
a
a
a
a
a
a
a
a
a
a
a
a
a
a
a
x
"}
(13,1,1) = {"
x
a
a
a
a
a
a
z
L
z
a
L
z
a
a
a
a
a
a
a
a
a
a
a
a
a
a
a
a
a
a
a
a
a
a
a
a
a
x
"}
(14,1,1) = {"
x
a
a
a
a
a
z
z
z
a
a
a
z
z
a
a
a
a
a
a
a
a
a
a
a
a
a
a
a
a
a
a
a
a
a
a
a
a
x
"}
(15,1,1) = {"
x
a
a
a
a
a
z
L
a
a
a
a
H
H
z
a
a
a
a
a
a
a
a
a
a
a
a
a
a
a
a
a
a
a
a
a
a
a
x
"}
(16,1,1) = {"
x
a
a
a
a
t
z
a
a
a
a
a
z
H
a
a
a
a
a
a
a
a
a
a
a
a
a
a
a
a
L
H
z
a
a
a
a
a
x
"}
(17,1,1) = {"
x
a
a
a
a
z
n
t
a
a
a
z
H
z
a
a
a
a
a
a
a
a
a
a
a
a
a
a
a
z
z
a
H
a
a
a
a
a
x
"}
(18,1,1) = {"
x
a
a
a
a
t
a
a
a
a
a
z
L
a
a
a
a
a
a
a
a
a
a
a
a
a
a
a
a
z
a
a
z
z
z
a
a
x
x
"}
(19,1,1) = {"
x
a
a
a
a
a
a
a
a
a
a
z
H
a
a
a
a
a
a
a
a
a
a
a
a
a
a
a
L
H
a
a
a
z
H
z
z
x
x
"}
(20,1,1) = {"
x
a
a
a
a
a
a
a
a
a
a
z
z
z
a
a
a
a
a
a
a
a
a
a
a
a
a
z
z
H
a
a
a
a
z
H
z
x
x
"}
(21,1,1) = {"
x
a
a
a
a
a
a
a
a
a
a
a
z
z
a
a
a
a
a
a
a
a
a
a
a
a
z
H
a
a
a
a
a
a
a
L
z
x
x
"}
(22,1,1) = {"
x
x
a
a
a
a
a
a
a
a
a
a
z
z
z
a
a
a
a
a
a
a
a
a
a
z
H
a
a
a
a
a
a
a
a
H
z
x
x
"}
(23,1,1) = {"
x
x
a
a
a
a
a
a
a
a
a
a
z
H
z
a
a
a
a
a
a
a
z
z
z
H
z
a
a
a
a
a
a
a
a
x
x
x
x
"}
(24,1,1) = {"
x
x
x
a
a
a
a
a
a
a
a
a
z
H
H
a
a
a
a
a
a
a
z
H
z
L
a
a
a
a
a
a
a
a
a
x
x
x
x
"}
(25,1,1) = {"
x
x
x
a
a
a
a
a
a
a
a
a
a
H
H
a
a
a
a
a
L
z
H
a
a
a
a
a
a
a
a
a
a
a
x
x
x
x
x
"}
(26,1,1) = {"
x
x
x
a
a
a
a
a
a
a
a
a
a
z
H
a
z
z
H
H
H
a
a
a
a
a
a
a
a
a
a
a
a
a
x
x
x
x
x
"}
(27,1,1) = {"
x
x
x
a
a
a
a
a
a
a
a
a
a
z
L
z
z
H
H
z
a
a
a
a
a
a
a
a
a
a
a
a
a
a
x
x
x
x
x
"}
(28,1,1) = {"
x
x
x
x
a
a
a
a
a
a
a
a
a
a
z
z
a
a
a
a
a
a
a
a
a
a
a
a
a
a
a
a
x
x
x
x
x
x
x
"}
(29,1,1) = {"
x
x
x
x
a
a
a
a
a
a
a
a
a
a
a
a
a
a
a
a
a
a
a
a
a
a
a
a
a
a
a
a
x
x
x
x
x
x
x
"}
(30,1,1) = {"
x
x
x
x
x
a
a
a
a
a
a
a
a
a
a
a
a
a
a
a
a
a
a
a
a
a
a
a
a
a
a
x
x
x
x
x
x
x
x
"}
(31,1,1) = {"
x
x
x
x
x
a
a
a
a
a
a
a
a
a
a
a
a
a
a
a
a
a
a
a
a
a
a
a
a
a
x
x
x
x
x
x
x
x
x
"}
(32,1,1) = {"
x
x
x
x
x
x
a
a
a
a
a
a
a
a
a
a
a
a
a
a
a
a
a
a
a
a
a
x
x
x
x
x
x
x
x
x
x
x
x
"}
(33,1,1) = {"
x
x
x
x
x
x
x
a
a
a
a
a
a
a
a
a
a
a
a
a
a
a
a
a
x
x
x
x
x
x
x
x
x
x
x
x
x
x
x
"}
(34,1,1) = {"
x
x
x
x
x
x
x
x
a
a
a
a
a
a
a
a
a
a
a
a
a
a
x
x
x
x
x
x
x
x
x
x
x
x
x
x
x
x
x
"}
(35,1,1) = {"
x
x
x
x
x
x
x
x
a
a
a
a
a
a
a
a
a
a
a
a
a
x
x
x
x
x
x
x
x
x
x
x
x
x
x
x
x
x
x
"}
(36,1,1) = {"
x
x
x
x
x
x
x
x
x
a
a
a
a
a
a
a
a
a
x
x
x
x
x
x
x
x
x
x
x
x
x
x
x
x
x
x
x
x
x
"}
(37,1,1) = {"
x
x
x
x
x
x
x
x
x
x
a
a
a
a
a
x
x
x
x
x
x
x
x
x
x
x
x
x
x
x
x
x
x
x
x
x
x
x
x
"}
(38,1,1) = {"
x
x
x
x
x
x
x
x
x
x
x
x
x
x
x
x
x
x
x
x
x
x
x
x
x
x
x
x
x
x
x
x
x
x
x
x
x
x
x
"}
