//MAP CONVERTED BY dmm2tgm.py THIS HEADER COMMENT PREVENTS RECONVERSION, DO NOT REMOVE
"a" = (
/turf/template_noop,
/area/space)
"d" = (
/obj/structure/flora/ausbushes/ywflowers,
/turf/template_noop,
/area/space)
"k" = (
/obj/structure/flora/ausbushes/brflowers,
/turf/template_noop,
/area/space)
"l" = (
/obj/structure/flora/tree/grove,
/turf/template_noop,
/area/space)
"w" = (
/turf/simulated/mineral/random/exoplanet,
/area/space)
"E" = (
/turf/simulated/mineral/preset/gold,
/area/space)
"N" = (
/obj/structure/flora/ausbushes/palebush,
/turf/template_noop,
/area/space)
"X" = (
/obj/structure/flora/ausbushes/grassybush,
/turf/template_noop,
/area/space)
"Y" = (
/obj/structure/flora/ausbushes/ppflowers,
/turf/template_noop,
/area/space)

(1,1,1) = {"
a
a
a
a
a
a
a
a
a
a
a
a
a
a
a
a
a
a
a
a
a
N
X
a
d
a
a
a
a
"}
(2,1,1) = {"
a
a
l
a
Y
a
X
a
a
a
a
a
a
l
a
a
a
a
a
a
a
a
a
a
d
E
E
a
N
"}
(3,1,1) = {"
a
a
a
a
a
a
a
a
k
a
a
a
a
a
a
X
a
a
a
l
a
a
a
a
a
E
E
E
a
"}
(4,1,1) = {"
a
a
a
a
a
N
a
a
k
a
a
a
a
a
a
a
a
a
a
a
a
N
a
a
a
E
E
E
X
"}
(5,1,1) = {"
a
a
a
Y
a
a
a
a
a
a
d
a
a
N
a
a
a
a
a
d
a
a
a
a
E
E
E
E
a
"}
(6,1,1) = {"
a
a
Y
a
a
a
a
l
a
a
a
a
a
a
a
a
a
a
a
a
a
a
a
N
E
E
E
E
a
"}
(7,1,1) = {"
a
a
a
a
a
a
a
a
a
a
a
a
a
a
a
a
a
N
a
a
a
a
E
E
E
E
E
E
N
"}
(8,1,1) = {"
a
l
a
N
a
a
a
a
N
a
a
X
a
a
a
l
a
a
Y
a
a
a
E
E
E
E
E
E
a
"}
(9,1,1) = {"
a
a
a
a
a
a
a
a
a
a
a
a
a
a
a
a
a
Y
a
X
a
E
E
E
E
E
E
E
a
"}
(10,1,1) = {"
a
X
a
a
a
a
a
a
a
l
a
a
a
a
a
a
a
Y
a
a
E
E
E
E
E
E
E
E
X
"}
(11,1,1) = {"
a
a
a
E
E
E
w
a
a
a
a
a
a
a
a
N
a
a
a
w
E
E
E
E
E
E
E
E
N
"}
(12,1,1) = {"
k
k
E
E
E
E
w
a
a
a
a
a
d
d
a
a
a
E
E
w
E
E
E
E
E
E
E
a
a
"}
(13,1,1) = {"
k
E
E
E
E
E
E
a
a
a
Y
d
d
a
a
E
E
E
E
w
E
E
E
E
E
w
a
a
Y
"}
(14,1,1) = {"
Y
E
E
E
E
E
E
w
w
a
N
a
a
a
E
E
E
E
E
E
E
w
w
w
a
a
a
a
d
"}
(15,1,1) = {"
a
E
E
E
E
E
E
E
w
w
a
a
a
E
E
E
E
E
E
w
w
w
w
a
Y
N
a
a
X
"}
(16,1,1) = {"
a
E
E
E
E
E
E
E
w
w
w
w
E
E
E
E
E
E
E
w
w
a
a
a
Y
a
a
a
a
"}
(17,1,1) = {"
X
a
w
w
E
E
E
E
w
w
w
w
E
E
E
E
E
w
w
w
a
X
a
a
a
a
l
a
a
"}
(18,1,1) = {"
a
a
w
w
E
E
E
E
w
w
w
E
E
E
E
E
E
w
a
N
a
a
a
Y
a
a
a
a
a
"}
(19,1,1) = {"
N
a
w
w
w
w
E
E
w
w
E
E
E
E
E
E
E
a
a
a
a
a
a
a
a
a
a
a
N
"}
(20,1,1) = {"
a
d
a
w
w
w
w
w
w
w
E
E
E
E
w
w
a
a
a
d
a
a
a
X
a
a
a
a
a
"}
(21,1,1) = {"
a
d
a
a
w
w
w
w
w
w
E
E
E
E
w
a
a
a
a
d
a
a
a
a
a
a
k
a
a
"}
(22,1,1) = {"
a
a
Y
a
a
w
w
w
w
w
E
E
w
a
a
a
X
a
Y
a
a
a
l
d
a
a
k
k
a
"}
(23,1,1) = {"
a
l
a
a
X
a
w
w
w
w
w
w
a
a
a
a
l
a
a
a
a
a
a
a
a
a
a
k
a
"}
(24,1,1) = {"
a
a
a
k
a
a
a
a
N
a
a
X
a
a
a
a
a
N
a
a
a
a
a
a
a
X
a
Y
a
"}
