//MAP CONVERTED BY dmm2tgm.py THIS HEADER COMMENT PREVENTS RECONVERSION, DO NOT REMOVE
"a" = (
/turf/template_noop,
/area/space)
"n" = (
/turf/simulated/mineral/preset/exoplanet/galena,
/area/space)
"Y" = (
/turf/simulated/mineral/random/exoplanet,
/area/space)

(1,1,1) = {"
a
a
a
a
a
a
a
a
a
a
a
a
a
a
a
a
a
a
a
a
a
a
a
a
a
a
a
a
a
a
a
a
"}
(2,1,1) = {"
a
a
a
a
a
a
a
a
a
a
a
a
n
a
a
a
a
a
a
a
a
a
a
a
a
a
a
a
a
a
a
a
"}
(3,1,1) = {"
a
a
a
a
a
a
a
a
a
a
a
n
n
n
n
a
a
a
a
a
a
a
a
a
a
a
a
a
a
a
a
a
"}
(4,1,1) = {"
a
a
a
a
a
a
a
a
n
n
n
n
n
n
n
n
a
a
a
a
a
a
a
a
a
a
a
a
a
Y
a
a
"}
(5,1,1) = {"
a
a
a
a
a
a
a
n
n
n
n
n
n
n
n
n
a
a
a
a
a
a
a
a
a
a
a
a
a
Y
a
a
"}
(6,1,1) = {"
a
a
a
a
a
a
a
n
n
n
n
n
n
n
n
n
n
a
a
a
a
a
a
a
a
a
a
a
a
Y
a
a
"}
(7,1,1) = {"
a
a
a
a
a
a
a
n
Y
n
n
n
n
n
n
n
n
a
a
a
a
a
a
a
a
a
a
a
Y
Y
a
a
"}
(8,1,1) = {"
a
a
a
a
a
a
n
n
Y
Y
Y
Y
n
n
n
n
n
n
a
a
a
a
a
a
a
a
a
a
Y
Y
Y
a
"}
(9,1,1) = {"
a
a
a
a
a
n
n
n
Y
Y
Y
Y
Y
n
n
n
n
n
a
a
a
a
a
a
a
a
a
a
n
n
Y
a
"}
(10,1,1) = {"
a
a
a
a
a
n
n
Y
Y
Y
Y
Y
Y
Y
n
n
n
n
a
a
a
a
a
a
a
a
a
a
n
n
Y
a
"}
(11,1,1) = {"
a
a
a
a
n
n
n
Y
Y
Y
a
Y
Y
Y
n
n
n
n
n
a
a
a
a
a
a
a
a
n
n
n
Y
a
"}
(12,1,1) = {"
a
a
a
a
n
n
Y
Y
Y
a
a
a
Y
Y
Y
n
n
n
n
a
a
a
a
a
a
a
a
n
n
n
Y
a
"}
(13,1,1) = {"
a
a
a
n
n
n
Y
Y
a
a
a
a
a
Y
Y
n
n
n
n
a
a
a
a
a
a
a
n
n
n
n
Y
a
"}
(14,1,1) = {"
a
a
a
n
n
Y
Y
Y
a
a
a
a
a
Y
Y
Y
n
n
n
n
a
a
a
a
a
a
n
n
n
n
Y
a
"}
(15,1,1) = {"
a
a
a
n
n
Y
Y
a
a
a
a
a
a
a
Y
Y
n
n
n
n
a
a
a
a
a
a
n
n
n
n
Y
a
"}
(16,1,1) = {"
a
a
n
n
n
Y
Y
a
a
a
a
a
a
a
Y
Y
n
n
n
n
a
a
a
a
a
n
n
n
Y
Y
Y
a
"}
(17,1,1) = {"
a
a
n
n
Y
Y
a
a
a
a
a
a
a
a
Y
Y
Y
n
n
n
n
a
a
a
n
n
n
Y
Y
Y
a
a
"}
(18,1,1) = {"
a
n
n
n
Y
Y
a
a
a
a
a
a
a
a
a
Y
Y
Y
n
n
n
a
a
n
n
n
n
Y
Y
Y
a
a
"}
(19,1,1) = {"
a
n
n
Y
Y
Y
a
a
a
a
a
a
a
a
a
Y
Y
Y
n
n
n
n
n
n
n
n
n
Y
Y
a
a
a
"}
(20,1,1) = {"
a
n
n
Y
Y
a
a
a
a
a
a
a
a
a
a
Y
Y
Y
Y
n
n
n
n
n
n
n
Y
Y
a
a
a
a
"}
(21,1,1) = {"
a
n
n
Y
Y
a
a
a
a
a
a
a
a
a
a
a
Y
Y
Y
n
n
n
n
Y
Y
Y
Y
a
a
a
a
a
"}
(22,1,1) = {"
a
n
n
Y
Y
a
a
a
a
a
a
a
a
a
a
a
Y
Y
Y
Y
Y
Y
Y
Y
Y
Y
Y
a
a
a
a
a
"}
(23,1,1) = {"
a
n
n
Y
a
a
a
a
a
a
a
a
a
a
a
a
a
Y
Y
Y
Y
Y
Y
Y
Y
a
a
a
a
a
a
a
"}
(24,1,1) = {"
a
n
n
Y
a
a
a
a
a
a
a
a
a
a
a
a
a
Y
Y
Y
Y
Y
Y
a
a
a
a
a
a
a
a
a
"}
(25,1,1) = {"
a
Y
Y
Y
a
a
a
a
a
a
a
a
a
a
a
a
a
a
a
a
a
a
a
a
a
a
a
a
a
a
a
a
"}
(26,1,1) = {"
a
a
Y
Y
a
a
a
a
a
a
a
a
a
a
a
a
a
a
a
a
a
a
a
a
a
a
a
a
a
a
a
a
"}
(27,1,1) = {"
a
a
Y
Y
a
a
a
a
a
a
a
a
a
a
a
a
a
a
a
a
a
a
a
a
a
a
a
a
a
a
a
a
"}
(28,1,1) = {"
a
a
a
Y
a
a
a
a
a
a
a
a
a
a
a
a
a
a
a
a
a
a
a
a
a
a
a
a
a
a
a
a
"}
(29,1,1) = {"
a
a
a
Y
a
a
a
a
a
a
a
a
a
a
a
a
a
a
a
a
a
a
a
a
a
a
a
a
a
a
a
a
"}
(30,1,1) = {"
a
a
a
a
a
a
a
a
a
a
a
a
a
a
a
a
a
a
a
a
a
a
a
a
a
a
a
a
a
a
a
a
"}
