//MAP CONVERTED BY dmm2tgm.py THIS HEADER COMMENT PREVENTS RECONVERSION, DO NOT REMOVE
"a" = (
/turf/simulated/mineral/random/exoplanet,
/area/space)
"b" = (
/obj/structure/flora/ausbushes/ppflowers,
/turf/template_noop,
/area/space)
"f" = (
/obj/structure/flora/ausbushes/ywflowers,
/turf/template_noop,
/area/space)
"j" = (
/obj/structure/flora/ausbushes/brflowers,
/turf/template_noop,
/area/space)
"m" = (
/obj/structure/flora/ausbushes/grassybush,
/turf/template_noop,
/area/space)
"n" = (
/obj/effect/decal/cleanable/blood/splatter,
/obj/random/melee/highvalue,
/turf/simulated/floor/exoplanet/barren/cave,
/area/space)
"q" = (
/obj/structure/flora/tree/grove,
/turf/template_noop,
/area/space)
"r" = (
/obj/structure/flora/ausbushes/palebush,
/turf/template_noop,
/area/space)
"t" = (
/obj/structure/closet/crate/loot/contraband,
/turf/simulated/floor/exoplanet/barren/cave,
/area/space)
"x" = (
/turf/template_noop,
/area/space)
"z" = (
/turf/simulated/floor/exoplanet/barren/cave,
/area/space)
"H" = (
/turf/simulated/floor/exoplanet/water/shallow,
/area/space)
"L" = (
/obj/effect/decal/cleanable/blood/drip,
/turf/simulated/floor/exoplanet/barren/cave,
/area/space)

(1,1,1) = {"
x
x
x
x
x
x
x
x
x
x
x
r
x
x
x
x
x
x
m
x
x
x
f
f
x
x
x
x
q
x
r
m
x
x
x
x
x
x
b
"}
(2,1,1) = {"
r
x
m
x
x
x
f
x
m
x
x
x
a
a
a
a
a
a
a
r
x
x
x
x
b
x
x
x
x
x
x
x
x
j
x
x
f
f
x
"}
(3,1,1) = {"
x
x
x
x
x
b
x
x
x
x
a
a
a
a
a
a
a
a
a
a
a
a
x
x
x
x
x
x
x
m
x
x
x
j
x
x
x
x
r
"}
(4,1,1) = {"
x
q
x
f
f
x
r
x
a
a
a
a
a
a
a
a
a
a
a
a
a
a
a
a
a
a
a
r
x
x
x
x
j
x
x
x
x
q
x
"}
(5,1,1) = {"
x
x
x
f
x
x
x
a
a
a
a
a
a
a
a
a
a
a
a
a
a
a
a
a
a
a
a
a
a
a
a
x
x
x
x
x
x
x
x
"}
(6,1,1) = {"
x
x
x
x
x
x
a
a
a
a
a
a
z
a
a
a
a
a
a
a
a
a
a
a
a
a
a
a
a
a
a
a
a
r
x
x
x
m
x
"}
(7,1,1) = {"
x
f
x
x
a
a
a
a
a
z
H
H
H
H
a
a
a
a
a
a
a
a
a
a
a
a
a
a
a
a
a
a
a
a
a
a
x
x
x
"}
(8,1,1) = {"
b
x
x
a
a
a
a
a
z
H
H
H
H
H
H
a
a
a
a
a
a
a
a
a
a
a
a
a
a
a
a
a
a
a
a
a
a
x
x
"}
(9,1,1) = {"
x
x
x
a
a
a
a
a
H
H
H
H
H
H
H
H
a
a
a
a
a
a
a
a
a
a
a
a
a
a
a
a
a
a
a
a
a
x
m
"}
(10,1,1) = {"
x
m
r
a
a
a
a
a
H
H
H
H
H
H
H
H
z
a
a
a
a
a
a
a
a
a
a
a
a
a
a
a
a
a
a
a
a
a
x
"}
(11,1,1) = {"
x
x
a
a
a
a
a
a
H
H
H
H
H
H
H
a
a
a
a
a
a
a
a
a
a
a
a
a
a
a
a
a
a
a
a
a
a
a
x
"}
(12,1,1) = {"
x
x
a
a
a
a
a
a
z
H
H
H
H
z
a
a
a
a
a
a
a
a
a
a
a
a
a
a
a
a
a
a
a
a
a
a
a
a
x
"}
(13,1,1) = {"
x
a
a
a
a
a
a
z
L
z
a
L
z
a
a
a
a
a
a
a
a
a
a
a
a
a
a
a
a
a
a
a
a
a
a
a
a
a
x
"}
(14,1,1) = {"
x
a
a
a
a
a
z
z
z
a
a
a
z
z
a
a
a
a
a
a
a
a
a
a
a
a
a
a
a
a
a
a
a
a
a
a
a
a
x
"}
(15,1,1) = {"
r
a
a
a
a
a
z
L
a
a
a
a
H
H
z
a
a
a
a
a
a
a
a
a
a
a
a
a
a
a
a
a
a
a
a
a
a
a
r
"}
(16,1,1) = {"
x
a
a
a
a
t
z
a
a
a
a
a
z
H
a
a
a
a
a
a
a
a
a
a
a
a
a
a
a
a
L
H
z
a
a
a
a
a
x
"}
(17,1,1) = {"
x
a
a
a
a
z
n
t
a
a
a
z
H
z
a
a
a
a
a
a
a
a
a
a
a
a
a
a
a
z
z
a
H
a
a
a
a
a
x
"}
(18,1,1) = {"
x
a
a
a
a
t
a
a
a
a
a
z
L
a
a
a
a
a
a
a
a
a
a
a
a
a
a
a
a
z
a
a
z
z
z
a
a
x
f
"}
(19,1,1) = {"
m
a
a
a
a
a
a
a
a
a
a
z
H
a
a
a
a
a
a
a
a
a
a
a
a
a
a
a
L
H
a
a
a
z
H
z
z
x
f
"}
(20,1,1) = {"
x
a
a
a
a
a
a
a
a
a
a
z
z
z
a
a
a
a
a
a
a
a
a
a
a
a
a
z
z
H
a
a
a
a
z
H
z
x
x
"}
(21,1,1) = {"
x
a
a
a
a
a
a
a
a
a
a
a
z
z
a
a
a
a
a
a
a
a
a
a
a
a
z
H
a
a
a
a
a
a
a
L
z
x
x
"}
(22,1,1) = {"
r
x
a
a
a
a
a
a
a
a
a
a
z
z
z
a
a
a
a
a
a
a
a
a
a
z
H
a
a
a
a
a
a
a
a
H
z
x
m
"}
(23,1,1) = {"
x
x
a
a
a
a
a
a
a
a
a
a
z
H
z
a
a
a
a
a
a
a
z
z
z
H
z
a
a
a
a
a
a
a
a
x
x
x
x
"}
(24,1,1) = {"
x
x
x
a
a
a
a
a
a
a
a
a
z
H
H
a
a
a
a
a
a
a
z
H
z
L
a
a
a
a
a
a
a
a
a
x
x
x
x
"}
(25,1,1) = {"
f
x
x
a
a
a
a
a
a
a
a
a
a
H
H
a
a
a
a
a
L
z
H
a
a
a
a
a
a
a
a
a
a
a
x
x
j
x
x
"}
(26,1,1) = {"
f
m
x
a
a
a
a
a
a
a
a
a
a
z
H
a
z
z
H
H
H
a
a
a
a
a
a
a
a
a
a
a
a
a
x
x
j
x
x
"}
(27,1,1) = {"
f
x
x
a
a
a
a
a
a
a
a
a
a
z
L
z
z
H
H
z
a
a
a
a
a
a
a
a
a
a
a
a
a
a
x
x
j
r
x
"}
(28,1,1) = {"
x
x
r
x
a
a
a
a
a
a
a
a
a
a
z
z
a
a
a
a
a
a
a
a
a
a
a
a
a
a
a
a
x
x
x
x
x
x
x
"}
(29,1,1) = {"
x
x
x
x
a
a
a
a
a
a
a
a
a
a
a
a
a
a
a
a
a
a
a
a
a
a
a
a
a
a
a
a
x
m
x
x
x
x
x
"}
(30,1,1) = {"
x
x
b
x
x
a
a
a
a
a
a
a
a
a
a
a
a
a
a
a
a
a
a
a
a
a
a
a
a
a
a
x
x
x
x
x
x
x
x
"}
(31,1,1) = {"
r
x
j
x
x
a
a
a
a
a
a
a
a
a
a
a
a
a
a
a
a
a
a
a
a
a
a
a
a
a
x
x
x
x
x
x
q
x
x
"}
(32,1,1) = {"
x
q
j
x
x
x
a
a
a
a
a
a
a
a
a
a
a
a
a
a
a
a
a
a
a
a
a
x
x
x
x
x
x
x
x
x
x
x
x
"}
(33,1,1) = {"
x
x
x
j
r
x
x
a
a
a
a
a
a
a
a
a
a
a
a
a
a
a
a
a
x
x
x
r
x
x
j
x
x
x
x
x
x
x
m
"}
(34,1,1) = {"
x
x
x
x
x
x
x
x
a
a
a
a
a
a
a
a
a
a
a
a
a
a
x
x
f
x
x
x
x
x
j
x
b
x
r
x
x
x
x
"}
(35,1,1) = {"
x
x
x
x
x
q
x
x
a
a
a
a
a
a
a
a
a
a
a
a
a
x
m
x
x
x
q
x
x
x
x
x
b
b
x
x
x
f
x
"}
(36,1,1) = {"
m
x
x
x
x
x
x
m
x
a
a
a
a
a
a
a
a
a
x
b
x
x
x
x
x
x
x
x
m
x
x
x
x
x
x
x
x
f
x
"}
(37,1,1) = {"
x
f
f
x
x
x
x
x
x
x
a
a
a
a
a
x
x
x
x
r
j
j
x
x
x
x
x
x
x
x
r
x
x
x
q
x
b
x
x
"}
(38,1,1) = {"
x
r
x
b
x
x
x
r
x
x
b
f
x
x
m
x
x
r
x
x
x
x
j
x
x
x
m
x
x
x
x
x
x
x
x
x
x
x
x
"}
