//MAP CONVERTED BY dmm2tgm.py THIS HEADER COMMENT PREVENTS RECONVERSION, DO NOT REMOVE
"a" = (
/turf/template_noop,
/area/space)
"i" = (
/obj/structure/flora/ausbushes/grassybush,
/turf/template_noop,
/area/space)
"j" = (
/turf/simulated/mineral/random/high_chance/exoplanet,
/area/space)
"n" = (
/turf/simulated/mineral/random/exoplanet,
/area/space)
"v" = (
/obj/structure/flora/ausbushes/ppflowers,
/turf/template_noop,
/area/space)
"A" = (
/obj/structure/flora/ausbushes/palebush,
/turf/template_noop,
/area/space)
"E" = (
/obj/structure/flora/tree/grove,
/turf/template_noop,
/area/space)
"M" = (
/obj/structure/flora/ausbushes/ywflowers,
/turf/template_noop,
/area/space)
"T" = (
/obj/structure/flora/ausbushes/brflowers,
/turf/template_noop,
/area/space)

(1,1,1) = {"
a
a
a
a
a
i
a
a
a
a
a
M
a
a
a
a
a
a
a
a
a
a
a
a
a
a
a
a
i
a
a
a
"}
(2,1,1) = {"
M
a
a
a
E
a
a
a
a
a
a
a
v
a
a
n
n
n
n
A
a
a
a
i
a
a
T
a
a
a
a
a
"}
(3,1,1) = {"
M
a
a
a
a
a
a
a
a
E
v
a
a
n
n
n
n
n
n
n
n
a
a
a
a
a
T
a
a
a
M
a
"}
(4,1,1) = {"
v
a
a
a
v
M
a
a
a
a
a
a
n
n
n
n
n
n
n
n
n
n
a
a
a
v
v
a
a
a
M
a
"}
(5,1,1) = {"
a
a
a
M
M
M
a
a
a
a
a
n
n
n
n
n
n
n
n
n
n
n
n
n
A
a
a
a
a
E
a
a
"}
(6,1,1) = {"
a
E
a
M
a
a
E
a
i
a
n
n
n
n
n
n
n
n
n
n
n
n
n
n
n
a
a
a
a
a
a
a
"}
(7,1,1) = {"
a
a
v
a
a
a
a
a
a
n
n
n
n
n
n
n
n
n
n
n
n
n
n
n
n
n
a
a
M
i
a
a
"}
(8,1,1) = {"
a
a
a
a
a
a
a
a
n
n
n
n
n
n
n
n
n
n
n
n
n
n
n
n
n
n
a
a
a
a
a
a
"}
(9,1,1) = {"
a
a
a
a
a
a
a
a
n
n
n
n
n
n
n
n
n
A
a
n
n
n
n
n
n
n
n
a
i
a
a
a
"}
(10,1,1) = {"
a
a
a
a
a
a
a
n
n
n
n
n
n
n
n
n
a
a
a
A
n
n
n
n
n
n
n
a
a
a
a
A
"}
(11,1,1) = {"
a
a
a
a
E
a
n
n
n
n
n
n
n
n
n
a
a
a
a
a
a
n
n
n
n
n
n
n
a
a
E
a
"}
(12,1,1) = {"
a
T
a
a
a
a
n
n
n
n
n
n
n
n
a
a
a
M
a
v
a
a
n
n
n
n
n
n
n
a
a
a
"}
(13,1,1) = {"
a
T
a
a
a
n
n
n
n
n
n
n
n
a
i
a
a
M
M
a
a
i
a
n
n
n
n
n
n
a
a
a
"}
(14,1,1) = {"
a
a
v
a
a
n
n
n
n
n
n
n
a
a
a
a
v
a
a
a
i
a
a
a
n
n
n
n
n
a
a
a
"}
(15,1,1) = {"
a
a
a
a
A
n
n
n
n
n
A
a
a
a
a
a
j
j
j
j
j
a
a
a
n
n
n
n
n
n
a
T
"}
(16,1,1) = {"
a
i
a
a
n
n
n
n
n
a
a
a
M
M
a
j
j
j
j
j
j
a
T
a
n
n
n
n
n
n
a
T
"}
(17,1,1) = {"
a
a
a
a
n
n
n
n
a
a
a
a
a
a
j
j
j
j
j
j
j
j
T
a
n
n
n
n
n
n
n
a
"}
(18,1,1) = {"
a
E
v
a
n
n
n
n
a
a
T
a
A
j
j
j
j
j
j
j
j
j
a
v
a
n
n
n
n
n
n
a
"}
(19,1,1) = {"
a
a
a
n
n
n
n
a
a
a
T
a
j
j
j
j
j
j
j
j
j
j
a
a
a
n
n
n
n
n
n
a
"}
(20,1,1) = {"
a
i
a
n
n
n
n
a
a
a
a
a
j
j
j
j
j
j
j
j
j
j
i
a
a
A
n
n
n
n
n
a
"}
(21,1,1) = {"
a
a
a
n
n
n
a
v
a
i
a
j
j
j
j
j
j
j
j
j
j
j
a
a
a
a
n
n
n
n
n
a
"}
(22,1,1) = {"
v
a
a
n
n
n
a
a
a
v
a
j
j
j
j
j
j
j
j
j
j
a
a
a
a
i
n
n
n
n
n
i
"}
(23,1,1) = {"
a
A
n
n
n
a
a
a
a
A
a
j
j
j
j
j
j
j
j
j
j
A
a
a
M
a
a
n
n
n
n
a
"}
(24,1,1) = {"
a
a
n
n
n
a
a
a
a
a
a
j
j
j
j
j
j
j
j
j
a
a
E
a
v
a
a
n
n
n
n
a
"}
(25,1,1) = {"
a
n
n
n
n
a
a
E
a
a
a
a
j
j
j
j
j
j
a
a
a
a
a
a
M
v
a
a
n
n
A
a
"}
(26,1,1) = {"
a
n
n
n
a
a
a
a
a
M
a
a
j
j
j
j
a
a
T
a
a
a
a
v
a
a
a
a
n
n
a
a
"}
(27,1,1) = {"
a
n
n
n
a
a
a
a
a
M
a
a
a
a
A
a
a
T
T
a
a
a
a
a
a
a
M
a
n
a
a
a
"}
(28,1,1) = {"
v
n
n
a
v
a
a
a
a
a
a
A
M
a
a
a
a
T
a
v
a
a
a
a
a
a
M
a
a
a
E
a
"}
(29,1,1) = {"
a
a
n
a
a
a
a
a
a
a
E
a
a
a
a
a
E
a
a
a
A
a
a
a
E
a
a
a
a
a
a
a
"}
(30,1,1) = {"
A
a
n
a
T
T
a
a
a
a
a
a
a
a
a
a
a
a
a
a
E
a
a
a
a
a
a
A
a
a
a
a
"}
(31,1,1) = {"
v
a
T
T
a
a
M
a
a
a
a
a
a
v
a
a
a
A
a
a
a
a
a
a
a
v
a
a
i
a
a
M
"}
