//MAP CONVERTED BY dmm2tgm.py THIS HEADER COMMENT PREVENTS RECONVERSION, DO NOT REMOVE
"a" = (
/turf/template_noop,
/area/space)
"c" = (
/turf/simulated/mineral/random/high_chance/exoplanet,
/area/space)
"G" = (
/obj/effect/landmark/clear,
/turf/template_noop,
/area/space)
"W" = (
/turf/simulated/mineral/random/exoplanet,
/area/space)

(1,1,1) = {"
a
a
a
a
a
a
a
a
a
a
a
a
a
a
a
a
a
a
a
a
a
a
a
a
a
a
a
a
"}
(2,1,1) = {"
a
a
a
W
a
a
a
a
a
a
a
a
a
a
a
a
W
W
a
a
a
a
a
a
a
a
a
a
"}
(3,1,1) = {"
a
a
a
W
a
a
a
a
a
a
a
a
a
a
W
W
W
W
W
W
a
a
a
a
a
a
a
a
"}
(4,1,1) = {"
a
a
a
W
a
a
G
a
a
a
a
a
W
W
W
c
c
c
W
W
W
a
a
a
a
a
a
a
"}
(5,1,1) = {"
a
a
W
W
a
G
G
G
a
a
W
W
W
W
W
c
c
c
W
W
W
W
a
a
a
a
a
a
"}
(6,1,1) = {"
a
a
W
W
G
G
G
G
G
W
c
c
c
W
W
c
c
c
W
W
W
W
W
W
a
a
a
a
"}
(7,1,1) = {"
a
a
W
W
W
G
G
G
G
W
c
c
c
W
W
W
W
W
W
W
W
W
c
W
a
a
a
a
"}
(8,1,1) = {"
a
a
W
W
W
G
G
G
W
W
c
c
c
W
W
W
W
W
G
G
W
W
c
W
a
a
a
a
"}
(9,1,1) = {"
a
a
W
W
W
G
G
G
W
W
W
W
W
W
W
W
G
G
G
G
G
W
c
W
W
a
a
a
"}
(10,1,1) = {"
a
W
W
W
W
G
G
G
W
W
W
W
G
G
G
G
G
G
G
G
G
G
W
W
W
a
a
a
"}
(11,1,1) = {"
a
W
W
W
W
G
G
W
W
W
W
G
G
G
c
G
G
G
G
G
G
G
W
W
W
a
a
a
"}
(12,1,1) = {"
a
W
W
W
W
G
G
W
W
G
G
G
G
c
c
c
G
G
G
G
G
G
G
W
W
W
a
a
"}
(13,1,1) = {"
a
W
W
W
W
W
G
G
G
G
G
G
c
c
c
c
c
G
G
G
G
G
G
G
W
W
a
a
"}
(14,1,1) = {"
a
W
W
W
W
W
W
G
G
G
G
G
G
c
c
c
G
G
G
W
W
G
G
G
W
W
W
a
"}
(15,1,1) = {"
a
W
W
W
W
W
W
G
G
G
G
G
G
G
c
G
G
G
W
W
W
G
G
G
G
W
W
a
"}
(16,1,1) = {"
a
a
W
W
W
W
W
W
G
G
G
G
G
G
G
G
G
W
W
W
W
G
G
G
G
W
W
a
"}
(17,1,1) = {"
a
a
W
W
W
W
W
W
W
G
G
G
G
G
G
G
W
W
W
W
G
G
G
G
G
G
W
a
"}
(18,1,1) = {"
a
a
a
W
W
W
W
W
W
W
W
G
G
G
W
W
W
W
W
W
a
G
G
G
G
a
W
a
"}
(19,1,1) = {"
a
a
a
W
W
W
W
W
W
W
W
W
W
W
W
W
W
W
W
a
a
a
G
G
a
a
W
a
"}
(20,1,1) = {"
a
a
a
a
W
W
W
W
c
c
c
c
c
c
W
W
W
W
W
a
a
a
a
a
a
a
a
a
"}
(21,1,1) = {"
a
a
a
a
W
W
W
W
c
c
c
c
c
c
W
W
W
a
a
a
a
a
a
a
a
a
a
a
"}
(22,1,1) = {"
a
a
a
a
a
a
W
W
c
c
c
c
c
c
W
W
a
a
a
a
a
a
a
a
a
a
a
a
"}
(23,1,1) = {"
a
a
a
a
a
a
a
W
W
W
W
W
W
W
W
a
a
a
a
a
a
a
a
a
a
a
a
a
"}
(24,1,1) = {"
a
a
a
a
a
a
a
a
a
W
W
W
W
a
a
a
a
a
a
a
a
a
a
a
a
a
a
a
"}
(25,1,1) = {"
a
a
a
a
a
a
a
a
a
a
a
a
a
a
a
a
a
a
a
a
a
a
a
a
a
a
a
a
"}
