//MAP CONVERTED BY dmm2tgm.py THIS HEADER COMMENT PREVENTS RECONVERSION, DO NOT REMOVE
"a" = (
/turf/template_noop,
/area/space)
"g" = (
/obj/structure/flora/ausbushes/ppflowers,
/turf/template_noop,
/area/space)
"n" = (
/turf/simulated/mineral/preset/galena,
/area/space)
"q" = (
/obj/structure/flora/tree/grove,
/turf/template_noop,
/area/space)
"t" = (
/obj/structure/flora/ausbushes/palebush,
/turf/template_noop,
/area/space)
"z" = (
/obj/structure/flora/ausbushes/grassybush,
/turf/template_noop,
/area/space)
"I" = (
/obj/structure/flora/ausbushes/brflowers,
/turf/template_noop,
/area/space)
"L" = (
/obj/structure/flora/ausbushes/ywflowers,
/turf/template_noop,
/area/space)
"Y" = (
/turf/simulated/mineral/random/exoplanet,
/area/space)

(1,1,1) = {"
a
a
t
a
a
a
a
a
a
z
a
a
a
a
a
a
a
a
a
a
a
a
a
a
a
a
a
a
a
a
a
a
"}
(2,1,1) = {"
a
a
a
a
a
a
a
a
a
a
a
a
n
a
a
a
a
t
a
a
a
a
I
a
a
a
a
a
a
a
a
a
"}
(3,1,1) = {"
a
a
q
a
a
a
a
a
a
a
a
n
n
n
n
a
a
a
a
a
a
a
I
a
a
a
t
a
a
a
a
a
"}
(4,1,1) = {"
a
a
a
a
a
a
a
a
n
n
n
n
n
n
n
n
a
a
a
a
a
a
a
a
a
a
a
a
a
Y
a
a
"}
(5,1,1) = {"
a
z
a
a
z
a
a
n
n
n
n
n
n
n
n
n
a
a
a
a
a
a
a
a
a
a
a
a
a
Y
a
a
"}
(6,1,1) = {"
a
a
a
a
I
a
a
n
n
n
n
n
n
n
n
n
n
a
a
a
a
a
a
a
a
a
a
a
a
Y
a
a
"}
(7,1,1) = {"
a
a
a
L
I
a
a
n
Y
n
n
n
n
n
n
n
n
a
a
a
a
a
a
a
a
a
a
a
Y
Y
a
a
"}
(8,1,1) = {"
a
a
a
L
a
a
n
n
Y
Y
Y
Y
n
n
n
n
n
n
a
g
a
a
a
a
q
a
a
a
n
Y
Y
a
"}
(9,1,1) = {"
a
a
a
a
a
n
n
n
Y
Y
Y
Y
Y
n
n
n
n
n
a
g
a
a
a
a
a
a
a
a
n
n
Y
a
"}
(10,1,1) = {"
a
q
a
z
a
n
n
Y
Y
Y
Y
Y
Y
Y
n
n
n
n
a
a
a
a
a
a
a
a
a
a
n
n
Y
a
"}
(11,1,1) = {"
a
a
a
a
n
n
n
Y
Y
Y
a
Y
Y
Y
n
n
n
n
n
a
a
a
a
a
a
a
a
n
n
n
Y
a
"}
(12,1,1) = {"
a
a
a
a
n
n
Y
Y
Y
a
a
a
Y
Y
Y
n
n
n
n
a
a
a
a
a
z
a
a
n
n
n
Y
a
"}
(13,1,1) = {"
a
a
a
n
n
n
Y
Y
a
a
t
a
a
Y
Y
n
n
n
n
a
a
a
a
a
a
a
n
n
n
n
Y
a
"}
(14,1,1) = {"
a
a
a
n
n
Y
Y
Y
a
a
a
a
a
Y
Y
Y
n
n
n
n
a
a
t
a
a
a
n
n
n
n
Y
a
"}
(15,1,1) = {"
z
a
a
n
n
Y
Y
z
a
a
a
a
a
a
Y
Y
n
n
n
n
a
a
a
a
a
a
n
n
n
n
Y
a
"}
(16,1,1) = {"
a
a
n
n
n
Y
Y
a
a
a
a
q
a
a
Y
Y
n
n
n
n
a
a
a
a
a
n
n
n
Y
Y
Y
a
"}
(17,1,1) = {"
a
a
n
n
Y
Y
a
a
a
a
a
a
a
z
Y
Y
Y
n
n
n
n
a
a
a
n
n
n
Y
Y
Y
a
a
"}
(18,1,1) = {"
a
n
n
n
Y
Y
a
a
a
a
a
a
a
a
a
Y
Y
Y
n
n
n
a
a
n
n
n
n
Y
Y
Y
a
a
"}
(19,1,1) = {"
a
n
n
Y
Y
Y
a
a
a
a
a
a
a
a
a
Y
Y
Y
n
n
n
n
n
n
n
n
n
Y
Y
a
a
a
"}
(20,1,1) = {"
t
n
n
Y
Y
a
a
a
a
a
t
a
a
a
a
Y
Y
Y
Y
n
n
n
n
n
n
n
Y
Y
a
a
a
a
"}
(21,1,1) = {"
a
n
n
Y
Y
a
a
z
a
a
a
a
a
a
a
a
Y
Y
Y
n
n
n
n
Y
Y
Y
Y
a
a
a
a
g
"}
(22,1,1) = {"
a
n
n
Y
Y
a
a
a
a
a
a
a
a
a
a
a
Y
Y
Y
Y
Y
Y
Y
Y
Y
Y
Y
a
a
a
a
g
"}
(23,1,1) = {"
a
n
n
Y
a
a
a
a
a
a
a
a
I
a
a
a
a
Y
Y
Y
Y
Y
Y
Y
Y
a
a
a
a
a
a
a
"}
(24,1,1) = {"
a
n
n
Y
z
a
a
a
a
a
a
a
a
L
a
a
a
Y
Y
Y
Y
Y
Y
a
a
a
a
a
a
q
a
a
"}
(25,1,1) = {"
a
Y
Y
Y
a
a
a
a
a
a
a
a
a
L
a
a
a
a
a
a
a
a
a
a
t
a
a
a
a
a
a
a
"}
(26,1,1) = {"
a
a
Y
Y
a
a
a
t
a
a
a
a
a
a
a
q
a
a
a
a
z
a
a
a
a
a
a
a
a
a
a
a
"}
(27,1,1) = {"
a
a
Y
Y
a
a
a
a
a
a
z
a
a
a
a
a
a
a
a
a
a
a
a
a
a
a
q
a
a
a
a
z
"}
(28,1,1) = {"
L
a
a
Y
a
a
q
a
a
a
a
a
a
a
a
a
a
a
a
a
a
a
a
a
a
a
a
a
a
a
a
a
"}
(29,1,1) = {"
L
a
a
Y
a
a
a
a
z
a
a
a
a
a
a
z
a
a
t
a
a
a
a
a
a
a
a
a
a
t
a
a
"}
(30,1,1) = {"
a
z
a
a
a
a
a
a
a
a
a
a
a
a
a
a
a
a
a
a
a
a
z
a
a
a
a
a
a
a
a
a
"}
