//MAP CONVERTED BY dmm2tgm.py THIS HEADER COMMENT PREVENTS RECONVERSION, DO NOT REMOVE
"a" = (
/turf/simulated/mineral/random/exoplanet,
/area/space)
"b" = (
/obj/structure/closet/crate/loot,
/turf/simulated/floor/exoplanet/barren/cave,
/area/space)
"c" = (
/turf/simulated/mineral/random/high_chance/exoplanet,
/area/space)
"g" = (
/obj/effect/landmark/clear,
/obj/effect/landmark/clear,
/turf/template_noop,
/area/space)
"i" = (
/turf/template_noop,
/area/space)
"m" = (
/turf/simulated/floor/exoplanet/barren/cave,
/area/space)
"u" = (
/obj/effect/landmark/clear,
/turf/template_noop,
/area/space)
"G" = (
/turf/simulated/floor/exoplanet/water/shallow,
/area/space)
"H" = (
/obj/effect/landmark/clear,
/turf/simulated/floor/exoplanet/water/shallow,
/area/space)
"T" = (
/obj/item/material/sword/dao,
/turf/simulated/floor/exoplanet/barren/cave,
/area/space)

(1,1,1) = {"
i
i
i
i
i
i
i
i
i
i
i
i
i
i
i
i
i
i
i
i
i
i
i
i
i
i
i
"}
(2,1,1) = {"
i
i
i
i
i
i
i
i
a
a
a
a
a
a
i
i
i
i
i
i
i
i
i
i
i
i
i
"}
(3,1,1) = {"
i
i
i
i
i
i
i
a
a
a
a
a
a
a
a
a
a
i
i
i
i
i
i
i
i
i
i
"}
(4,1,1) = {"
i
i
i
i
i
a
a
a
a
a
a
a
a
a
a
a
a
a
i
i
i
i
i
i
i
i
i
"}
(5,1,1) = {"
i
i
i
i
a
a
a
a
a
a
a
a
a
a
a
a
a
a
a
a
i
i
i
i
i
i
i
"}
(6,1,1) = {"
i
i
i
i
a
a
a
a
a
a
a
m
m
m
G
m
m
a
a
a
a
i
i
i
i
i
i
"}
(7,1,1) = {"
i
i
i
a
a
a
a
a
a
a
m
G
m
m
m
m
m
m
a
a
a
a
i
i
i
i
i
"}
(8,1,1) = {"
i
i
i
a
a
a
a
a
m
m
m
m
a
a
a
a
G
G
G
a
a
a
i
i
i
i
i
"}
(9,1,1) = {"
i
i
a
a
a
a
a
a
m
G
m
c
c
c
a
a
a
a
G
G
m
a
a
i
i
i
i
"}
(10,1,1) = {"
i
i
a
a
a
a
a
a
m
m
m
c
c
c
a
a
a
a
a
m
m
a
a
i
i
i
i
"}
(11,1,1) = {"
i
i
a
a
a
a
a
a
m
m
c
c
c
c
c
c
a
a
a
m
m
m
a
i
i
i
i
"}
(12,1,1) = {"
i
i
a
a
a
a
a
m
m
G
c
c
c
c
c
c
a
a
a
a
m
m
m
u
u
i
i
"}
(13,1,1) = {"
i
i
a
a
a
a
a
m
m
G
c
c
c
c
c
c
c
a
a
a
G
m
m
u
u
i
i
"}
(14,1,1) = {"
i
a
a
a
a
a
a
m
m
G
m
c
c
c
c
c
c
a
a
a
a
m
m
H
u
u
i
"}
(15,1,1) = {"
i
a
a
a
a
a
a
m
G
m
m
G
G
G
c
c
c
a
a
a
a
a
u
u
u
u
i
"}
(16,1,1) = {"
i
a
a
a
a
a
a
m
m
m
G
G
G
G
G
c
c
a
a
a
a
a
H
u
u
u
u
"}
(17,1,1) = {"
i
a
a
a
a
a
a
m
m
G
G
G
G
G
G
G
c
a
a
a
a
a
u
H
H
u
u
"}
(18,1,1) = {"
i
a
a
a
a
a
a
a
a
G
G
G
G
G
G
G
c
a
a
a
a
u
u
u
u
u
u
"}
(19,1,1) = {"
i
a
a
a
a
a
a
a
a
G
G
G
G
G
G
m
c
a
a
a
a
u
H
u
u
u
u
"}
(20,1,1) = {"
i
i
a
a
a
a
a
a
a
a
G
G
G
G
m
a
a
a
a
a
u
u
u
u
u
u
u
"}
(21,1,1) = {"
i
i
i
a
a
a
a
a
a
a
a
b
m
T
a
a
a
a
a
a
u
u
u
u
u
g
u
"}
(22,1,1) = {"
i
i
i
i
a
a
a
a
a
a
a
a
a
a
a
a
a
a
a
a
u
u
u
u
u
u
i
"}
(23,1,1) = {"
i
i
i
i
i
a
a
a
a
a
a
a
a
a
a
a
a
a
a
u
u
u
u
u
u
i
i
"}
(24,1,1) = {"
i
i
i
i
i
i
a
a
a
a
a
a
a
a
a
a
a
a
i
i
u
u
u
u
i
i
i
"}
(25,1,1) = {"
i
i
i
i
i
i
i
a
a
a
a
a
a
a
a
a
a
i
i
i
i
u
u
i
i
i
i
"}
(26,1,1) = {"
i
i
i
i
i
i
i
i
i
i
i
i
i
i
i
i
i
i
i
i
i
i
i
i
i
i
i
"}
