//MAP CONVERTED BY dmm2tgm.py THIS HEADER COMMENT PREVENTS RECONVERSION, DO NOT REMOVE
"a" = (
/turf/template_noop,
/area/space)
"c" = (
/turf/simulated/mineral/random/high_chance/exoplanet,
/area/space)
"F" = (
/obj/structure/flora/tree/grove,
/turf/template_noop,
/area/space)
"H" = (
/obj/structure/flora/ausbushes/ywflowers,
/turf/template_noop,
/area/space)
"L" = (
/obj/structure/flora/ausbushes/grassybush,
/turf/template_noop,
/area/space)
"T" = (
/obj/structure/flora/ausbushes/ppflowers,
/turf/template_noop,
/area/space)
"W" = (
/turf/simulated/mineral/random/exoplanet,
/area/space)
"X" = (
/obj/structure/flora/ausbushes/brflowers,
/turf/template_noop,
/area/space)
"Z" = (
/obj/structure/flora/ausbushes/palebush,
/turf/template_noop,
/area/space)

(1,1,1) = {"
a
a
a
a
a
a
a
a
a
a
a
H
H
a
L
a
Z
a
a
T
a
a
a
a
a
a
Z
a
"}
(2,1,1) = {"
X
a
a
W
a
a
a
a
F
H
H
a
a
a
a
a
W
W
a
a
H
H
a
a
F
a
a
X
"}
(3,1,1) = {"
X
a
a
W
a
T
a
a
a
a
a
a
T
T
W
W
W
W
W
W
a
a
a
a
a
a
X
X
"}
(4,1,1) = {"
a
L
a
W
T
a
a
a
a
Z
a
a
W
W
W
c
c
c
W
W
W
a
a
T
a
L
X
a
"}
(5,1,1) = {"
a
a
W
W
a
a
a
X
a
a
W
W
W
W
W
c
c
c
W
W
W
W
a
T
a
a
a
a
"}
(6,1,1) = {"
a
a
W
W
a
a
a
X
a
W
c
c
c
W
W
c
c
c
W
W
W
W
W
W
a
a
F
Z
"}
(7,1,1) = {"
T
a
W
W
W
a
T
a
a
W
c
c
c
W
W
W
W
W
W
W
W
W
c
W
a
a
a
a
"}
(8,1,1) = {"
a
a
W
W
W
L
a
a
W
W
c
c
c
W
W
W
W
W
a
a
W
W
c
W
a
a
a
T
"}
(9,1,1) = {"
a
a
W
W
W
a
a
a
W
W
W
W
W
W
W
W
a
a
a
a
a
W
c
W
W
Z
H
a
"}
(10,1,1) = {"
a
W
W
W
W
a
a
a
W
W
W
W
X
a
a
a
a
a
a
F
a
a
W
W
W
a
a
H
"}
(11,1,1) = {"
a
W
W
W
W
T
a
W
W
W
W
a
a
a
c
a
a
a
a
a
Z
a
W
W
W
a
a
H
"}
(12,1,1) = {"
a
W
W
W
W
a
a
W
W
a
a
a
a
c
c
c
a
a
X
X
a
L
a
W
W
W
a
a
"}
(13,1,1) = {"
a
W
W
W
W
W
a
L
a
H
a
Z
c
c
c
c
c
a
X
a
a
a
a
a
W
W
L
a
"}
(14,1,1) = {"
H
W
W
W
W
W
W
a
H
a
a
a
a
c
c
c
a
H
a
W
W
a
T
a
W
W
W
a
"}
(15,1,1) = {"
H
W
W
W
W
W
W
a
a
a
a
F
a
a
c
a
a
a
W
W
W
a
a
H
a
W
W
a
"}
(16,1,1) = {"
a
a
W
W
W
W
W
W
a
a
a
a
T
Z
a
a
a
W
W
W
W
a
H
a
a
W
W
T
"}
(17,1,1) = {"
a
L
W
W
W
W
W
W
W
a
a
a
T
L
a
a
W
W
W
W
a
a
a
H
a
a
W
T
"}
(18,1,1) = {"
a
L
a
W
W
W
W
W
W
W
W
X
a
a
W
W
W
W
W
W
a
a
a
H
a
a
W
a
"}
(19,1,1) = {"
T
a
a
W
W
W
W
W
W
W
W
W
W
W
W
W
W
W
W
a
T
a
a
a
a
a
W
a
"}
(20,1,1) = {"
T
a
X
a
W
W
W
W
c
c
c
c
c
c
W
W
W
W
W
a
Z
a
a
a
L
a
a
a
"}
(21,1,1) = {"
a
a
X
a
W
W
W
W
c
c
c
c
c
c
W
W
W
a
Z
a
a
T
a
a
a
a
Z
a
"}
(22,1,1) = {"
a
a
a
a
Z
a
W
W
c
c
c
c
c
c
W
W
a
a
a
a
a
T
a
a
a
F
a
a
"}
(23,1,1) = {"
a
F
a
L
a
a
a
W
W
W
W
W
W
W
W
a
T
L
a
X
a
a
a
a
a
a
a
T
"}
(24,1,1) = {"
a
a
H
a
T
a
X
a
a
W
W
W
W
Z
a
a
a
F
a
X
Z
a
H
a
a
a
a
H
"}
(25,1,1) = {"
Z
a
H
a
a
X
X
a
a
Z
a
a
a
a
a
a
a
a
T
a
a
T
H
a
L
a
H
H
"}
