//MAP CONVERTED BY dmm2tgm.py THIS HEADER COMMENT PREVENTS RECONVERSION, DO NOT REMOVE
"a" = (
/turf/simulated/mineral/random/exoplanet,
/area/space)
"b" = (
/obj/structure/closet/crate/loot/contraband,
/turf/simulated/floor/exoplanet/barren/cave,
/area/space)
"c" = (
/turf/simulated/mineral/random/high_chance/exoplanet,
/area/space)
"g" = (
/obj/effect/landmark/clear,
/obj/effect/landmark/clear,
/turf/template_noop,
/area/space)
"i" = (
/turf/template_noop,
/area/space)
"k" = (
/obj/structure/flora/tree/grove,
/turf/template_noop,
/area/space)
"m" = (
/turf/simulated/floor/exoplanet/barren/cave,
/area/space)
"u" = (
/obj/effect/landmark/clear,
/turf/template_noop,
/area/space)
"y" = (
/obj/structure/flora/ausbushes/ppflowers,
/turf/template_noop,
/area/space)
"G" = (
/turf/simulated/floor/exoplanet/water/shallow,
/area/space)
"H" = (
/obj/effect/landmark/clear,
/turf/simulated/floor/exoplanet/water/shallow,
/area/space)
"K" = (
/obj/structure/flora/ausbushes/grassybush,
/turf/template_noop,
/area/space)
"N" = (
/obj/structure/flora/ausbushes/brflowers,
/turf/template_noop,
/area/space)
"T" = (
/obj/item/material/sword/dao,
/turf/simulated/floor/exoplanet/barren/cave,
/area/space)
"V" = (
/obj/structure/flora/ausbushes/ywflowers,
/turf/template_noop,
/area/space)
"X" = (
/obj/structure/flora/ausbushes/palebush,
/turf/template_noop,
/area/space)

(1,1,1) = {"
y
i
i
i
y
i
K
i
i
i
K
i
i
i
i
i
i
V
i
i
i
i
y
i
i
i
X
"}
(2,1,1) = {"
i
i
i
k
i
N
i
i
a
a
a
a
a
a
X
i
y
K
i
i
i
k
i
y
i
N
N
"}
(3,1,1) = {"
i
i
i
i
i
y
i
a
a
a
a
a
a
a
a
a
a
i
i
i
i
i
i
i
i
i
N
"}
(4,1,1) = {"
i
i
i
i
i
a
a
a
a
a
a
a
a
a
a
a
a
a
i
i
i
i
i
i
k
i
N
"}
(5,1,1) = {"
i
i
i
i
a
a
a
a
a
a
a
a
a
a
a
a
a
a
a
a
X
i
i
i
i
K
i
"}
(6,1,1) = {"
k
V
i
X
a
a
a
a
a
a
a
m
m
m
G
m
m
a
a
a
a
i
i
i
i
i
i
"}
(7,1,1) = {"
i
V
i
a
a
a
a
a
a
a
m
G
m
m
m
m
m
m
a
a
a
a
i
V
i
y
K
"}
(8,1,1) = {"
i
K
i
a
a
a
a
a
m
m
m
m
a
a
a
a
G
G
G
a
a
a
X
i
i
i
i
"}
(9,1,1) = {"
i
i
a
a
a
a
a
a
m
G
m
c
c
c
a
a
a
a
G
G
m
a
a
i
i
k
V
"}
(10,1,1) = {"
N
i
a
a
a
a
a
a
m
m
m
c
c
c
a
a
a
a
a
m
m
a
a
i
i
i
V
"}
(11,1,1) = {"
i
i
a
a
a
a
a
a
m
m
c
c
c
c
c
c
a
a
a
m
m
m
a
i
i
i
i
"}
(12,1,1) = {"
i
i
a
a
a
a
a
m
m
G
c
c
c
c
c
c
a
a
a
a
m
m
m
u
u
i
k
"}
(13,1,1) = {"
i
X
a
a
a
a
a
m
m
G
c
c
c
c
c
c
c
a
a
a
G
m
m
u
u
i
i
"}
(14,1,1) = {"
y
a
a
a
a
a
a
m
m
G
m
c
c
c
c
c
c
a
a
a
a
m
m
H
u
u
i
"}
(15,1,1) = {"
y
a
a
a
a
a
a
m
G
m
m
G
G
G
c
c
c
a
a
a
a
a
u
u
u
u
X
"}
(16,1,1) = {"
i
a
a
a
a
a
a
m
m
m
G
G
G
G
G
c
c
a
a
a
a
a
H
u
u
u
u
"}
(17,1,1) = {"
i
a
a
a
a
a
a
m
m
G
G
G
G
G
G
G
c
a
a
a
a
a
u
H
H
u
u
"}
(18,1,1) = {"
i
a
a
a
a
a
a
a
a
G
G
G
G
G
G
G
c
a
a
a
a
u
u
u
u
u
u
"}
(19,1,1) = {"
K
a
a
a
a
a
a
a
a
G
G
G
G
G
G
m
c
a
a
a
a
u
H
u
u
u
u
"}
(20,1,1) = {"
i
i
a
a
a
a
a
a
a
a
G
G
G
G
m
a
a
a
a
a
u
u
u
u
u
u
u
"}
(21,1,1) = {"
i
i
y
a
a
a
a
a
a
a
a
b
m
T
a
a
a
a
a
a
u
u
u
u
u
g
u
"}
(22,1,1) = {"
i
V
i
i
a
a
a
a
a
a
a
a
a
a
a
a
a
a
a
a
u
u
u
u
u
u
V
"}
(23,1,1) = {"
i
i
i
i
i
a
a
a
a
a
a
a
a
a
a
a
a
a
a
u
u
u
u
u
u
i
k
"}
(24,1,1) = {"
i
k
i
N
i
i
a
a
a
a
a
a
a
a
a
a
a
a
y
X
u
u
u
u
i
i
i
"}
(25,1,1) = {"
i
i
i
N
K
X
i
a
a
a
a
a
a
a
a
a
a
i
i
k
i
u
u
y
X
i
i
"}
(26,1,1) = {"
X
i
i
i
y
i
i
y
i
i
V
y
i
i
i
V
i
i
i
i
V
i
y
N
N
i
y
"}
