//MAP CONVERTED BY dmm2tgm.py THIS HEADER COMMENT PREVENTS RECONVERSION, DO NOT REMOVE
"a" = (
/turf/template_noop,
/area/space)
"w" = (
/turf/simulated/mineral/random/exoplanet,
/area/space)
"E" = (
/turf/simulated/mineral/preset/exoplanet/gold,
/area/space)

(1,1,1) = {"
a
a
a
a
a
a
a
a
a
a
a
a
a
a
a
a
a
a
a
a
a
a
a
a
a
a
a
a
a
"}
(2,1,1) = {"
a
a
a
a
a
a
a
a
a
a
a
a
a
a
a
a
a
a
a
a
a
a
a
a
a
E
E
a
a
"}
(3,1,1) = {"
a
a
a
a
a
a
a
a
a
a
a
a
a
a
a
a
a
a
a
a
a
a
a
a
a
E
E
E
a
"}
(4,1,1) = {"
a
a
a
a
a
a
a
a
a
a
a
a
a
a
a
a
a
a
a
a
a
a
a
a
a
E
E
E
a
"}
(5,1,1) = {"
a
a
a
a
a
a
a
a
a
a
a
a
a
a
a
a
a
a
a
a
a
a
a
a
E
E
E
E
a
"}
(6,1,1) = {"
a
a
a
a
a
a
a
a
a
a
a
a
a
a
a
a
a
a
a
a
a
a
a
a
E
E
E
E
a
"}
(7,1,1) = {"
a
a
a
a
a
a
a
a
a
a
a
a
a
a
a
a
a
a
a
a
a
a
E
E
E
E
E
E
a
"}
(8,1,1) = {"
a
a
a
a
a
a
a
a
a
a
a
a
a
a
a
a
a
a
a
a
a
a
E
E
E
E
E
E
a
"}
(9,1,1) = {"
a
a
a
a
a
a
a
a
a
a
a
a
a
a
a
a
a
a
a
a
a
E
E
E
E
E
E
E
a
"}
(10,1,1) = {"
a
a
a
a
a
a
a
a
a
a
a
a
a
a
a
a
a
a
a
a
E
E
E
E
E
E
E
E
a
"}
(11,1,1) = {"
a
a
a
E
E
E
w
a
a
a
a
a
a
a
a
a
a
a
a
w
E
E
E
E
E
E
E
E
a
"}
(12,1,1) = {"
a
a
E
E
E
E
w
a
a
a
a
a
a
a
a
a
a
E
E
w
E
E
E
E
E
E
E
a
a
"}
(13,1,1) = {"
a
E
E
E
E
E
E
a
a
a
a
a
a
a
a
E
E
E
E
w
E
E
E
E
E
w
a
a
a
"}
(14,1,1) = {"
a
E
E
E
E
E
E
w
w
a
a
a
a
a
E
E
E
E
E
w
w
w
w
w
a
a
a
a
a
"}
(15,1,1) = {"
a
E
E
E
E
E
E
E
w
w
a
a
a
E
E
E
E
E
E
w
w
w
w
a
a
a
a
a
a
"}
(16,1,1) = {"
a
E
E
E
E
E
E
E
w
w
w
w
E
E
E
E
E
E
w
w
w
a
a
a
a
a
a
a
a
"}
(17,1,1) = {"
a
a
w
w
E
E
E
E
w
w
w
w
E
E
E
E
E
w
w
w
a
a
a
a
a
a
a
a
a
"}
(18,1,1) = {"
a
a
w
w
E
E
E
E
w
w
w
E
E
E
E
E
E
w
a
a
a
a
a
a
a
a
a
a
a
"}
(19,1,1) = {"
a
a
w
w
w
w
E
w
w
w
E
E
E
E
E
E
E
a
a
a
a
a
a
a
a
a
a
a
a
"}
(20,1,1) = {"
a
a
a
w
w
w
w
w
w
w
E
E
E
E
w
w
a
a
a
a
a
a
a
a
a
a
a
a
a
"}
(21,1,1) = {"
a
a
a
a
w
w
w
w
w
w
E
E
E
E
w
a
a
a
a
a
a
a
a
a
a
a
a
a
a
"}
(22,1,1) = {"
a
a
a
a
a
w
w
w
w
w
E
E
w
a
a
a
a
a
a
a
a
a
a
a
a
a
a
a
a
"}
(23,1,1) = {"
a
a
a
a
a
a
w
w
w
w
w
w
a
a
a
a
a
a
a
a
a
a
a
a
a
a
a
a
a
"}
(24,1,1) = {"
a
a
a
a
a
a
a
a
a
a
a
a
a
a
a
a
a
a
a
a
a
a
a
a
a
a
a
a
a
"}
